..............#####................................
..............#...#................................
....#############.#................................
....#.........#.#.#................................
#############.#######..............................
#...#.......#...#.#.#..............................
#...#.......#...#.#.#.....................#########
#...#.......#...#.#.#.....................#.......#
#####.......#...#.#.#.....................#.......#
............#...#.#.#.....................#.......#
....#############.#.#.....................#.......#
....#.......#.....#.#.....................#.......#
....#.#############.#.....................#.......#
....#.#.....#.......#.....................#.......#
....#.#.....#.....#############.......#############
....#.#.....#.....#.#.........#.......#...#........
....#.#.....#########.........#.......#...#........
....#.#...........#...........#.......#...#........
....#.#.#########.#...........#.......#...######^..
....#.#.#.......#.#...........#.......#............
....#.#############...........#.......#............
....#...#.......#.............#.......#............
....#####.......#.............#.......#............
................#.............#.......#............
................#.............#.......#............
................#.............#.......#............
................#.............#########............
................#..................................
................#..................................
................#..................................
................#############......................